..............................
..............................
..............................
..............................
..............................
..............................
..............................
..............................
.............................#
.............................#
.............................#
.............................#
.............................#
.............................#
.............................#
.............................#
.S........../#################
.........../##################
........../###################
........./####################
......../#####################
......./######################
##############################
##############################
##############################
##############################
##############################
##############################
##############################
##############################
##############################
