.........
...****.*
.........
.S.......
***......
.........
