..............................
.............................#
.............................#
.......####....######........#
...............34**21........#
.................[]..........#
.............................#
................./\..........#
...............rR##Ll........#
.S.####........******...######
........................######
........../###################
........./####################
......../#####################
......./######################
##############################
##############################
##############################
##############################
##############################
##############################
##############################
##############################
##############################
