................................................
...****#########################################
................................................
.S..............................................
***.............................................
................................................
